111111
10P001
100CC1
10C001
100001
110011
1000C1
11CCE1
100001
1C1011
111111