11111111111111111111
100000E0000000000001
1000P000000000000C01
10000000000000000001
11111111111111111111