1111111111111111111111111111111111111111
100000E000000000000000000000000000000001
1000P000000000000C000C000C000C000C000C01
1000000000000000000CCCCC0000000000C00001
1111111111111111111111111111111111111111