1111111111111111111111111111111
100000E000000110000000000000001
1000P000000000000C000C000C000C1
1000000000010000000CCCCC00001C1
1111111111111111111111111111111